Rk,Team,G,MP,FG,FGA,FG%,3P,3PA,3P%,2P,2PA,2P%,FT,FTA,FT%,ORB,DRB,TRB,AST,STL,BLK,TOV,PF,PTS,PA/G
1,Memphis Grizzlies*,82,19855,2691,6172,.436,408,1223,.334,2283,4949,.461,1465,1942,.754,927,2404,3331,1605,597,456,1213,1867,7255,88.5
2,San Antonio Spurs*,82,19805,2782,6420,.433,300,886,.339,2482,5534,.449,1414,1912,.740,886,2417,3303,1336,599,343,1136,1709,7278,88.8
3,Detroit Pistons*,82,19830,2915,6450,.452,329,1012,.325,2586,5438,.476,1235,1677,.736,951,2399,3350,1541,481,285,1145,1726,7394,90.2
4,Houston Rockets,82,19830,2708,6310,.429,541,1465,.369,2167,4845,.447,1560,2135,.731,874,2477,3351,1647,582,373,1094,1716,7517,91.7
5,Indiana Pacers*,82,19730,2831,6504,.435,371,1083,.343,2460,5421,.454,1511,2060,.733,968,2416,3384,1520,661,399,1112,1800,7544,92.0
6,New Jersey Nets*,82,19780,2730,6222,.439,465,1336,.348,2265,4886,.464,1654,2232,.741,787,2599,3386,1641,589,329,1177,1889,7579,92.4
7,Dallas Mavericks*,82,19880,2801,6319,.443,404,1120,.361,2397,5199,.461,1626,2163,.752,935,2209,3144,1433,536,400,1151,1958,7632,93.1
8,Minnesota Timberwolves,82,19855,2852,6474,.441,447,1229,.364,2405,5245,.459,1525,2072,.736,974,2411,3385,1554,539,374,1139,1736,7676,93.6
9,Utah Jazz,82,19880,2730,6077,.449,490,1297,.378,2240,4780,.469,1839,2466,.746,871,2237,3108,1511,663,463,1166,2104,7789,95.0
10,Cleveland Cavaliers*,82,19830,2949,6481,.455,459,1291,.356,2490,5190,.480,1462,1970,.742,807,2421,3228,1666,540,357,1079,1842,7819,95.4
11,New Orleans/Oklahoma City Hornets,82,19805,2883,6286,.459,546,1486,.367,2337,4800,.487,1530,2014,.760,860,2498,3358,1584,527,432,1197,1910,7842,95.6
12,Los Angeles Clippers*,82,19805,2887,6638,.435,474,1367,.347,2413,5271,.458,1593,2175,.732,858,2432,3290,1765,570,355,1053,1777,7841,95.6
13,Miami Heat*,82,19755,2871,6529,.440,490,1359,.361,2381,5170,.461,1642,2223,.739,826,2359,3185,1596,560,298,1063,1938,7874,96.0
14,Orlando Magic,82,19905,2870,6327,.454,460,1287,.357,2410,5040,.478,1672,2285,.732,911,2239,3150,1644,615,386,1099,1899,7872,96.0
15,Los Angeles Lakers*,82,19855,2945,6547,.450,474,1342,.353,2471,5205,.475,1585,2123,.747,893,2399,3292,1730,536,354,1158,1925,7949,96.9
16,Chicago Bulls*,82,19905,2773,6515,.426,501,1428,.351,2272,5087,.447,1921,2472,.777,881,2541,3422,1652,611,420,1228,1883,7968,97.2
17,Sacramento Kings*,82,19830,3053,6726,.454,462,1316,.351,2591,5410,.479,1412,1891,.747,953,2503,3456,1733,656,403,1199,1886,7980,97.3
18,Portland Trail Blazers,82,19730,3032,6472,.468,498,1306,.381,2534,5166,.491,1498,1971,.760,1029,2445,3474,1737,592,403,1060,1704,8060,98.3
19,Milwaukee Bucks*,82,19855,2972,6383,.466,490,1385,.354,2482,4998,.497,1671,2237,.747,832,2475,3307,1847,606,414,1182,1937,8105,98.8
20,Boston Celtics,82,19880,2944,6462,.456,446,1265,.353,2498,5197,.481,1825,2457,.743,910,2369,3279,1763,688,404,1210,1837,8159,99.5
21,Washington Wizards*,82,19830,3014,6477,.465,501,1379,.363,2513,5098,.493,1655,2222,.745,964,2477,3441,1766,537,341,1326,2075,8184,99.8
22,Golden State Warriors,82,19830,3047,6674,.457,469,1335,.351,2578,5339,.483,1624,2187,.743,985,2662,3647,1828,576,409,1258,1919,8187,99.8
23,Denver Nuggets*,82,19930,3070,6764,.454,530,1480,.358,2540,5284,.481,1538,2090,.736,965,2469,3434,1959,586,436,1323,1911,8208,100.1
24,Charlotte Bobcats,82,19905,3065,6410,.478,458,1285,.356,2607,5125,.509,1683,2283,.737,940,2667,3607,1881,577,441,1464,1929,8271,100.9
25,Philadelphia 76ers,82,19905,3100,6699,.463,498,1420,.351,2602,5279,.493,1609,2111,.762,974,2533,3507,1882,630,386,1269,1898,8307,101.3
26,New York Knicks,82,19930,2967,6359,.467,565,1495,.378,2402,4864,.494,1868,2480,.753,883,2280,3163,1744,674,437,1154,2079,8367,102.0
27,Atlanta Hawks,82,19880,3075,6433,.478,444,1205,.368,2631,5228,.503,1768,2372,.745,981,2335,3316,1689,597,422,1227,1855,8362,102.0
28,Phoenix Suns*,82,19955,3243,7141,.454,516,1423,.363,2727,5718,.477,1429,1956,.731,1028,2735,3763,1546,591,282,1218,1623,8431,102.8
29,Toronto Raptors,82,19955,3164,6448,.491,508,1363,.373,2656,5085,.522,1696,2267,.748,835,2539,3374,1938,518,359,1165,1834,8532,104.0
30,Seattle SuperSonics,82,19830,3202,6596,.485,542,1445,.375,2660,5151,.516,1713,2255,.760,1003,2316,3319,1973,598,399,1194,1820,8659,105.6