
Rk,Team,G,MP,FG,FGA,FG%,3P,3PA,3P,2P,2PA,2P,FT,FTA,FT%,ORB,DRB,TRB,AST,STL,BLK,TOV,PF,PTS,PTS/G
1,PhoenixSuns,82,19955,3430,7167,.479,837,2097,.399,2593,5070,.511,1189,1475,.806,778,2650,3428,2179,549,412,1088,1683,8886,108.4
2,SeattleSuperSonics,82,19830,3077,6711,.459,605,1631,.371,2472,5080,.487,1652,2104,.785,1013,2233,3246,1696,622,306,1208,1933,8411,102.6
3,WashingtonWizards,82,19830,2975,6656,.447,497,1394,.357,2478,5262,.471,1889,2496,.757,1035,2344,3379,1523,658,339,1143,1855,8336,101.7
4,TorontoRaptors,82,19955,3013,6639,.454,608,1620,.375,2405,5019,.479,1653,2089,.791,864,2291,3155,1593,529,272,1071,1965,8287,101.1
5,DenverNuggets,82,19930,3078,6672,.461,350,1076,.325,2728,5596,.487,1721,2312,.744,903,2486,3389,1921,698,463,1216,1863,8227,100.3
6,MiamiHeat,82,19755,3039,6355,.478,497,1441,.345,2542,4914,.517,1616,2310,.700,858,2675,3533,1692,522,442,1186,1871,8191,99.9
7,Philadelphia76ers,82,19905,3001,6546,.458,375,1031,.364,2626,5515,.476,1770,2330,.760,873,2425,3298,1653,651,404,1159,1712,8147,99.4
8,LosAngelesLakers,82,19855,2992,6607,.453,552,1583,.349,2440,5024,.486,1618,2172,.745,970,2488,3458,1734,628,350,1143,1894,8154,99.4
9,DallasMavericks,82,19880,2948,6375,.462,416,1113,.374,2532,5262,.481,1818,2322,.783,1030,2431,3461,1473,593,488,1112,1834,8130,99.1
10,SacramentoKings,82,19830,2954,6500,.454,494,1408,.351,2460,5092,.483,1704,2173,.784,852,2473,3325,1825,608,299,1199,1672,8106,98.9
11,GoldenStateWarriors,82,19830,2939,6785,.433,625,1832,.341,2314,4953,.467,1573,2190,.718,980,2485,3465,1694,604,357,1156,1941,8076,98.5
12,BostonCeltics,82,19880,2951,6322,.467,467,1290,.362,2484,5032,.494,1664,2204,.755,813,2432,3245,1716,578,422,1359,2033,8033,98.0
13,MilwaukeeBucks,82,19855,2976,6566,.453,507,1335,.380,2469,5231,.472,1561,2115,.738,929,2448,3377,1769,597,270,1197,1902,8020,97.8
14,ChicagoBulls,82,19905,3004,6737,.446,560,1477,.379,2444,5260,.465,1452,1967,.738,906,2602,3508,1804,508,345,1224,2038,8020,97.8
15,ClevelandCavaliers,82,19830,2908,6412,.454,497,1465,.339,2411,4947,.487,1689,2318,.729,959,2511,3470,1560,567,392,1137,1733,8002,97.6
16,AtlantaHawks,82,19880,2946,6496,.454,424,1154,.367,2522,5342,.472,1656,2207,.750,1069,2232,3301,1625,587,394,1284,2054,7972,97.2
17,LosAngelesClippers,82,19805,2993,6443,.465,290,843,.344,2703,5600,.483,1694,2142,.791,828,2704,3532,1708,534,503,1185,1872,7970,97.2
18,CharlotteBobcats,82,19905,2961,6843,.433,428,1261,.339,2533,5582,.454,1593,2186,.729,990,2270,3260,1717,822,354,1167,1960,7943,96.9
19,DetroitPistons,82,19830,2983,6558,.455,557,1451,.384,2426,5107,.475,1418,1950,.727,975,2347,3322,1971,580,490,931,1513,7941,96.8
20,NewYorkKnicks,82,19930,2822,6206,.455,320,884,.362,2502,5322,.470,1878,2587,.726,1034,2360,3394,1468,555,271,1449,2157,7842,95.6
21,SanAntonioSpurs,82,19805,2993,6342,.472,524,1362,.385,2469,4980,.496,1327,1891,.702,851,2548,3399,1717,543,467,1126,1714,7837,95.6
22,OrlandoMagic,82,19905,2911,6167,.472,299,796,.376,2612,5371,.486,1663,2277,.730,892,2402,3294,1495,532,362,1240,1908,7784,94.9
23,IndianaPacers,82,19730,2786,6274,.444,536,1536,.349,2250,4738,.475,1591,2158,.737,898,2559,3457,1631,598,409,1254,1821,7699,93.9
24,NewJerseyNets,82,19780,2778,6317,.440,477,1447,.330,2301,4870,.472,1658,2187,.758,822,2539,3361,1884,558,278,1119,1903,7691,93.8
25,NewOrleans/OklahomaCityHornets,82,19805,2831,6428,.440,300,885,.339,2531,5543,.457,1649,2176,.758,918,2379,3297,1519,611,311,1095,1786,7611,92.8
26,UtahJazz,82,19880,2744,6207,.442,311,925,.336,2433,5282,.461,1774,2466,.719,1071,2380,3451,1772,524,492,1290,2032,7573,92.4
27,MemphisGrizzlies,82,19855,2746,6125,.448,590,1578,.374,2156,4547,.474,1476,2077,.711,834,2379,3213,1586,600,442,1134,1757,7558,92.2
28,MinnesotaTimberwolves,82,19855,2888,6340,.456,310,942,.329,2578,5398,.478,1436,1895,.758,811,2422,3233,1716,559,471,1189,1889,7522,91.7
29,HoustonRockets,82,19830,2708,6252,.433,469,1414,.332,2239,4838,.463,1502,1980,.759,849,2565,3414,1580,588,320,1193,1863,7387,90.1
30,PortlandTrailBlazers,82,19730,2791,6267,.445,364,1042,.349,2427,5225,.464,1339,1944,.689,886,2203,3089,1490,529,435,1205,1828,7285,88.8
,LeagueAverage,82,19852,2939,6477,.454,470,1310,.358,2469,5167,.478,1607,2157,.745,916,2442,3358,1690,588,385,1182,1866,7955,97.0